The following modules are available:
autostart              - Manage which programs start up automatically with KDE.
bell                   - System Bell Configuration
bookmarks              - Configure the bookmarks home page
cache                  - Configure web cache settings
clock                  - Configure date and time settings
colors                 - Change the colors used in applications
componentchooser       - Choose the default components for various services
cookies                - Configure the way cookies work
cursortheme            - Customise the mouse cursor appearance
desktoppath            - Change the location important files are stored
desktoptheme           - Customise the desktop theme
device_automounter_kcm - Configure automatic handling of removable storage media
display                - Display Settings
ebrowsing              - Configure enhanced browsing
emoticons              - Choose Emoticon Theme
filetypes              - Configure file associations
fonts                  - Font settings
icons                  - Customise KDE Icons
kcm_akonadi_resources  - Configuration of the Akonadi Personal Information Management framework
kcm_attica             - Manage Social Desktop Providers
kcm_cron               - Configure and schedule tasks
kcm_kdnssd             - Configure service discovery
kcm_nepomuk            - Nepomuk Server Configuration
kcm_ssl                - SSL Versions and Certificates
kcm_useraccount        - User information such as password, name and email
kcmcgi                 - Configure the CGI KIO slave
kcmdf                  - Shows the disk usage of the mounted devices
kcmdolphingeneral      - Configure general file manager settings
kcmdolphinnavigation   - Configure file manager navigation
kcmdolphinservices     - Configure file manager services
kcmdolphinviewmodes    - Configure file manager view modes
kcmhistory             - Configure the history sidebar
kcmkded                - KDE Services Configuration
kcmlaunch              - Choose application-launch feedback style
kcmnotify              - System Notification Configuration
kcmperformance         - Configure settings that can improve KDE performance
kcmtrash               - Configure wastebin settings
keys                   - Configuration of keybindings
khtml_appearance       - Configure how to display web pages
khtml_behavior         - Configure the browser behaviour
khtml_filter           - Configure Konqueror AdBlocK filters
khtml_general          - Configure general Konqueror behaviour
khtml_java_js          - Configure the behaviour of Java and JavaScript
kresources             - Configure KDE Resources
kwalletconfig          - KDE Wallet Configuration
language               - Language, numeric, and time settings for your particular region
mouse                  - Mouse settings
netpref                - Configure generic network preferences, like timeout values
proxy                  - Configure the proxy servers used
smb                    - Use to configure which windows (SMB) filesystems you can browse
spellchecking          - Configure the spell checker
standard_actions       - Configuration of standard keybindings
style                  - Allows the manipulation of widget behaviour and changing the Style for KDE
useragent              - Configure the way Konqueror reports itself
workspaceoptions       - Global options for the Plasma Workspace
